NO    te     s     t.xmp










     WE   test.xmp


      C       255,    -6,  0

			F 255,    -6,  0

EAte s		t.xmp
			SO						   test.xmp




111    
1011           1         1      
                                 1             11
1001
    111  
11111              11S11111
          1        
     1111111