WE src/inc/textures/greyWall.xpm
NO src/inc/textures/blueWall.xpm
SO src/inc/textures/redWall.xpm
EA src/inc/textures/pissWall.xpm


F 128,128,128

CF
C 255,00002505, 53



1
111111111
1110111
1111111
11111
111



