NO    te     s     t.xmp










WE   test.xmp






EAte s		t.xmp
SO						   test.xmp


F 200,100,0
C       255,30,0







1111
100011111   11111111
1110001111111N11 101    
  100011111 111   1
 11111      111



							x

