NO inc/textures/greyWall.xpm
SO inc/textures/blueWall.xpm
WE inc/textures/redWall.xpm
EA inc/textures/pissWall.xpm

F 200,100,0
C 255,30,0

1111111111111111111111111
10N000000011000000000010  
100000000111000000011111 
1001000000000001000000011
1111111110110000011110001
1111111111111111111111111