NO src/inc/textures/wood.xpm
SO src/inc/textures/blueWall.xpm
WE src/inc/textures/redWall.xpm
EA src/inc/textures/pissWall.xpm

Fuck
F 200,100,0
C 255,30,0

111111
100001
101011
11N001
111111
