NO    te     s     t.xmp










WE   test.xmp






EAte s		t.xmp
SO						   test.xmp


F -8908,-1  ,  98



C       255,30,0




1111
100011111   1111  111
1110N01111111011  101    
  100011111 111    1
 11111      111



							

