NO      test.xmp
SO    test.xmp
WE /path_to_west_texture
EA /path_to_east_texture


F 200,100,0
C       255,30,0







1        10011
10010111111111
101001
1100N1
111111




