NO    te     s     t.xmp










WE   test.xmp


C       255,-3,  0



EAte s		t.xmp
SO						   test.xmp


F -8908, 75,  -4








1111         
100011111   1111  111 1    
1110001111 N1  11011  001   
  100011111 111    1  11   
 11111      111



							