NO    te     s     t.xmp










     WE   test.xmp


      C       255,    -6,  0

			F 255,    -6,  0

EAte s		t.xmp
			SO						   test.xmp




111111      111

 1111 1     1111
100N11  1   101
111111      111