WE src/inc/textures/greyWall.xpm
NO src/inc/textures/blueWall.xpm
SO src/inc/textures/redWall.xpm
EA src/inc/textures/pissWall.xpm

Fuck
F 200,100,0
C 255,30,0

        1111111111111111111111111
        1000000000110000000000001
        1011000001110000000000001
        1001000000000000000000001
111111111011000001110000000000001
100000000011000001110111100111111
11110111111111011100000010001
11110111111111011101010010001
11000000110101011100000010001
10000000000000001100000010001
10000000000000001101010010001
11000001110101011111011110S01
11110111 1110101 111111010001
11111111 1111111 111111111111
