NO inc/textures/greyWall.xpm
SO inc/textures/blueWall.xpm
WE inc/textures/redWall.xpm
EA inc/textures/pissWall.xpm

F 200,100,0
C 255,30,0

111111
111111
111101
1111N1
111111