NO    te     s     t.xmp










     WE   test.xmp


      C       255,    -6,  0

			F 255,    -6,  0

EAte s		t.xmp
			SO						   test.xmp




111 11
10N11  1
111111