WE src/inc/textures/greyWall.xpm
NO src/inc/textures/blueWall.xpm
SO src/inc/textures/redWall.xpm
EA src/inc/textures/pissWall.xpm

F 128,128,128
C 1,0,1

111111
10N001
111111