WE src/inc/textures/greyWall.xpm
NO src/inc/textures/blueWall.xpm
SO src/inc/textures/redWall.xpm
EA src/inc/textures/pissWall.xpm

Fuck
F 200,100,0
C 255,30,0

111111111
100100001
100010101
10N000001
111111111
