NO    te     s     t.xmp










WE   test.xmp






EAte s		t.xmp
SO						   test.xmp


F 200,100,0
C       255,30,0







1        10011  
1001011 1111111
101001
1100N1
       111111




							x