NO inc/textures/greyWall.xpm
SO inc/textures/blueWall.xpm
WE inc/textures/redWall.xpm
EA inc/textures/pissWall.xpm

F 200,100,0
C 255,30,0

11111111111111111
10S01100000000001
10011000000011111 
10000100000001111
11111111101110001
11111111111111111
