WE src/inc/textures/greyWall.xpm
NO src/inc/textures/blueWall.xpm
F 128,128,128
C 1,0,0
C
SO src/inc/textures/redWall.xpm
EA src/inc/textures/redWall.xpm

1111
1N11
1111