NO    te     s     t.xmp










     WE   test.xmp


      C       255,    -6,  0

			F 255,    -6,  0

EAte s		t.xmp
			SO						   test.xmp




111    
1011           1         1      
                              N   1             11
    111  
11111              1111111
                  





							