NO inc/textures/wood.xpm
SO inc/textures/blueWall.xpm
WE inc/textures/redWall.xpm
EA inc/textures/pissWall.xpm

Fuck
F 200,100,0
C 255,30,0

11111
1N001
10011
10001
11111
