NO inc/textures/wood.xpm
SO inc/textures/blueWall.xpm
WE inc/textures/redWall.xpm
EA inc/textures/pissWall.xpm

Fuck
F 200,100,0
C 255,30,0

1111
1N01
1011
1001
1111
