WE src/inc/textures/greyWall.xpm
NO src/inc/textures/blueWall.xpm

    SO src/inc/textures/redWall.xpm
EA src/inc/textures/pissWall.xpm
f
F128,128,128

C 255,255,1
C
111111
10N001
111111