NO inc/textures/greyWall.xpm
SO inc/textures/blueWall.xpm
WE inc/textures/redWall.xpm

EA inc/textures/pissWall.xpm




F 200,100,0
C 200,100,0

1111111111111111111111111
10N0000000110000000000101 
1000000001110000000111111
1001000000000001000000011
111111111011000001v110001
1111111111111111111111111