WE src/inc/textures/blueWall.xpm
NO src/inc/textures/greyWall.xpm
SO src/inc/textures/redWall.xpm
EA src/inc/textures/pissWall.xpm

C 64,224,208
F 234,221, 220

1111
1001
1S01
1001
1111
