NO ./Texture/redbrick.xpm
SO ./Texture/greystone.xpm
WE ./Texture/nazi.xpm
EA ./Texture/colorstone.xpm

F 600,400,20
C 128,0,0

      
11111111111111111111
      11000S0001 
11111111011111111111 
10111100011 
1010010011   
111001011 
10101111      
10000101111111111111111111
1000000000000000111
11111111111111111111    


